//MAP CONVERTED BY dmm2tgm.py THIS HEADER COMMENT PREVENTS RECONVERSION, DO NOT REMOVE
"aH" = (
/obj/structure/window/reinforced{
	dir = 4
	},
/obj/structure/table/wood,
/obj/item/resonator/upgraded,
/turf/simulated/floor/mineral/titanium/yellow,
/area/shuttle/freegolem)
"aM" = (
/obj/structure/table/wood,
/obj/item/storage/firstaid/adv,
/obj/item/storage/firstaid/adv,
/turf/simulated/floor/mineral/titanium/purple,
/area/shuttle/freegolem)
"bo" = (
/obj/machinery/light/small,
/obj/structure/closet/crate/golemgear,
/turf/simulated/floor/plating,
/area/shuttle/freegolem)
"bQ" = (
/obj/structure/window/reinforced{
	dir = 8
	},
/obj/structure/window/reinforced,
/obj/structure/table/wood,
/obj/item/resonator,
/turf/simulated/floor/mineral/titanium/yellow,
/area/shuttle/freegolem)
"ci" = (
/obj/structure/window/reinforced{
	dir = 4
	},
/obj/structure/window/reinforced,
/obj/structure/table/wood,
/obj/item/resonator,
/turf/simulated/floor/mineral/titanium/yellow,
/area/shuttle/freegolem)
"cV" = (
/obj/machinery/vending/hydroseeds,
/obj/machinery/light{
	dir = 1;
	on = 1
	},
/turf/simulated/floor/mineral/titanium/purple,
/area/shuttle/freegolem)
"dh" = (
/turf/simulated/wall/mineral/titanium/nodiagonal,
/area/shuttle/freegolem)
"dN" = (
/obj/structure/window/reinforced{
	dir = 8
	},
/obj/structure/window/reinforced{
	dir = 1
	},
/obj/structure/table/wood,
/obj/item/resonator,
/turf/simulated/floor/mineral/titanium/yellow,
/area/shuttle/freegolem)
"fr" = (
/obj/machinery/vending/snack/free,
/obj/machinery/light,
/turf/simulated/floor/mineral/titanium/purple,
/area/shuttle/freegolem)
"fT" = (
/turf/simulated/floor/plating,
/area/shuttle/freegolem)
"jV" = (
/obj/structure/table/wood,
/obj/item/disk/design_disk/golem_shell,
/obj/item/areaeditor/golem,
/turf/simulated/floor/mineral/titanium/purple,
/area/shuttle/freegolem)
"ml" = (
/turf/simulated/floor/mineral/titanium/blue,
/area/shuttle/freegolem)
"mG" = (
/obj/machinery/light/small,
/turf/simulated/floor/mineral/titanium/blue,
/area/shuttle/freegolem)
"mV" = (
/obj/structure/chair/comfy/purp{
	dir = 8
	},
/turf/simulated/floor/mineral/titanium/purple,
/area/shuttle/freegolem)
"oS" = (
/obj/structure/closet/crate/golemgear,
/turf/simulated/floor/plating,
/area/shuttle/freegolem)
"oW" = (
/obj/machinery/mineral/ore_redemption/golem,
/turf/simulated/floor/mineral/titanium/purple,
/area/shuttle/freegolem)
"qm" = (
/obj/structure/table/wood,
/obj/machinery/reagentgrinder,
/turf/simulated/floor/mineral/titanium/purple,
/area/shuttle/freegolem)
"qI" = (
/obj/machinery/vending/coffee/free,
/turf/simulated/floor/mineral/titanium/purple,
/area/shuttle/freegolem)
"qJ" = (
/obj/structure/window/reinforced{
	dir = 8
	},
/obj/structure/window/reinforced,
/obj/structure/computerframe,
/turf/simulated/floor/mineral/titanium/purple,
/area/shuttle/freegolem)
"th" = (
/obj/effect/spawner/window/shuttle,
/turf/simulated/floor/plating,
/area/shuttle/freegolem)
"us" = (
/turf/simulated/floor/mineral/titanium/yellow,
/area/shuttle/freegolem)
"wk" = (
/obj/machinery/light,
/turf/simulated/floor/mineral/titanium/purple,
/area/shuttle/freegolem)
"xY" = (
/obj/structure/table/wood,
/obj/structure/window/reinforced{
	dir = 1
	},
/obj/structure/window/reinforced{
	dir = 4
	},
/obj/item/resonator,
/turf/simulated/floor/mineral/titanium/yellow,
/area/shuttle/freegolem)
"ze" = (
/obj/structure/fans/tiny,
/obj/machinery/door/airlock/titanium,
/turf/simulated/floor/plating,
/area/shuttle/freegolem)
"zr" = (
/obj/structure/fans/tiny,
/turf/simulated/floor/mineral/titanium/purple,
/area/shuttle/freegolem)
"zI" = (
/obj/structure/window/reinforced{
	dir = 8
	},
/obj/structure/window/reinforced{
	dir = 1
	},
/obj/structure/computerframe,
/turf/simulated/floor/mineral/titanium/purple,
/area/shuttle/freegolem)
"As" = (
/obj/machinery/light/small{
	dir = 1
	},
/obj/structure/ore_box,
/turf/simulated/floor/plating,
/area/shuttle/freegolem)
"AD" = (
/obj/structure/table/wood,
/obj/item/storage/firstaid/brute,
/obj/item/storage/firstaid/brute,
/obj/item/storage/firstaid/brute,
/turf/simulated/floor/mineral/titanium/purple,
/area/shuttle/freegolem)
"AI" = (
/obj/structure/window/reinforced{
	dir = 8
	},
/obj/structure/table/wood,
/turf/simulated/floor/mineral/titanium/yellow,
/area/shuttle/freegolem)
"BN" = (
/turf/simulated/floor/plating/asteroid/basalt/lava_land_surface,
/area/ruin/powered/golem_ship)
"CQ" = (
/obj/structure/table/wood,
/obj/item/bedsheet/rd/royal_cape{
	layer = 3;
	pixel_x = 5;
	pixel_y = 9
	},
/obj/item/book/manual/research_and_development{
	name = "Sacred Text of the Liberator";
	pixel_x = -4;
	pixel_y = 3
	},
/turf/simulated/floor/mineral/titanium/yellow,
/area/shuttle/freegolem)
"Fm" = (
/obj/structure/shuttle/engine/heater{
	dir = 4
	},
/obj/structure/window/reinforced{
	dir = 8
	},
/turf/simulated/floor/plating,
/area/shuttle/freegolem)
"Fp" = (
/obj/structure/shuttle/engine/propulsion{
	dir = 4;
	icon_state = "burst_l"
	},
/turf/simulated/floor/plating,
/area/shuttle/freegolem)
"Fv" = (
/obj/structure/fans/tiny,
/obj/machinery/door/airlock/multi_tile/glass{
	dir = 1
	},
/turf/simulated/floor/mineral/titanium/purple,
/area/shuttle/freegolem)
"Ge" = (
/obj/machinery/door/airlock/titanium,
/turf/simulated/floor/mineral/titanium/blue,
/area/shuttle/freegolem)
"HE" = (
/obj/structure/computerframe,
/obj/structure/table/reinforced,
/turf/simulated/floor/mineral/titanium/purple,
/area/shuttle/freegolem)
"Ih" = (
/obj/machinery/vending/hydronutrients,
/turf/simulated/floor/mineral/titanium/purple,
/area/shuttle/freegolem)
"JS" = (
/obj/structure/reagent_dispensers/watertank/high,
/turf/simulated/floor/plating,
/area/shuttle/freegolem)
"Kq" = (
/obj/machinery/computer/shuttle/golem_ship/recall,
/turf/simulated/floor/plating/asteroid/basalt/lava_land_surface,
/area/ruin/powered/golem_ship)
"Ms" = (
/obj/machinery/door/airlock/titanium,
/turf/simulated/floor/mineral/titanium/purple,
/area/shuttle/freegolem)
"NP" = (
/obj/item/reagent_containers/spray/cleaner,
/obj/item/storage/toolbox/mechanical,
/turf/simulated/floor/mineral/titanium/purple,
/area/shuttle/freegolem)
"Oc" = (
/obj/structure/ore_box,
/turf/simulated/floor/plating,
/area/shuttle/freegolem)
"Pd" = (
/obj/machinery/autolathe,
/turf/simulated/floor/mineral/titanium/purple,
/area/shuttle/freegolem)
"Px" = (
/turf/simulated/floor/mineral/titanium/purple,
/area/shuttle/freegolem)
"Re" = (
/obj/machinery/light{
	dir = 1;
	on = 1
	},
/turf/simulated/floor/mineral/titanium/purple,
/area/shuttle/freegolem)
"RS" = (
/obj/effect/mob_spawn/human/golem/adamantine,
/turf/simulated/floor/mineral/titanium/yellow,
/area/shuttle/freegolem)
"UR" = (
/obj/structure/table/reinforced,
/turf/simulated/floor/mineral/titanium/purple,
/area/shuttle/freegolem)
"Wd" = (
/obj/structure/table/wood,
/obj/item/storage/firstaid/fire,
/obj/item/storage/firstaid/fire,
/obj/item/storage/firstaid/fire,
/obj/machinery/light,
/turf/simulated/floor/mineral/titanium/purple,
/area/shuttle/freegolem)
"WW" = (
/obj/docking_port/stationary{
	area_type = /area/ruin/powered/golem_ship;
	dir = 8;
	dwidth = 8;
	height = 20;
	id = "freegolem_lavaland";
	name = "Lavaland Surface";
	turf_type = /turf/simulated/floor/plating/asteroid/basalt/lava_land_surface;
	width = 16
	},
/obj/docking_port/mobile{
	dir = 8;
	dwidth = 8;
	height = 20;
	id = "freegolem";
	name = "Free Golem Ship";
	width = 16
	},
/turf/simulated/wall/mineral/titanium/nodiagonal,
/area/shuttle/freegolem)
"XM" = (
/obj/machinery/light/small{
	dir = 1
	},
/turf/simulated/floor/mineral/titanium/blue,
/area/shuttle/freegolem)
"Zl" = (
/turf/template_noop,
/area/template_noop)
"Zp" = (
/obj/machinery/mineral/equipment_vendor/golem,
/turf/simulated/floor/mineral/titanium/purple,
/area/shuttle/freegolem)
"ZQ" = (
/obj/structure/reagent_dispensers/fueltank,
/turf/simulated/floor/plating,
/area/shuttle/freegolem)

(1,1,1) = {"
Zl
Zl
Zl
Zl
Zl
Zl
Zl
Zl
dh
th
th
th
th
th
dh
Zl
Zl
Zl
Zl
Zl
Zl
Zl
Zl
"}
(2,1,1) = {"
Zl
Zl
Zl
Zl
Zl
Zl
Zl
Zl
th
UR
UR
HE
UR
UR
th
Zl
Zl
Zl
Zl
Zl
Zl
Zl
Zl
"}
(3,1,1) = {"
Zl
Zl
Zl
Zl
Zl
Zl
Zl
Zl
th
Px
Px
mV
Px
Px
th
Zl
Zl
Zl
Zl
Zl
Zl
Zl
Zl
"}
(4,1,1) = {"
Zl
Zl
Zl
Zl
Zl
Zl
Zl
Zl
th
qJ
Px
Px
Px
zI
th
Zl
Zl
Zl
Zl
Zl
Zl
Zl
Zl
"}
(5,1,1) = {"
Zl
Zl
Zl
Zl
Zl
Zl
Zl
dh
dh
mV
Px
Px
Px
mV
dh
dh
Zl
Zl
Zl
Zl
Zl
Zl
Zl
"}
(6,1,1) = {"
Zl
Zl
Zl
Zl
Zl
Zl
Zl
dh
Ih
Px
Px
Px
Px
Px
qI
dh
Zl
Zl
Zl
Zl
Zl
Zl
Zl
"}
(7,1,1) = {"
Zl
Zl
Zl
Zl
dh
th
dh
dh
cV
Px
Px
Px
Px
Px
fr
dh
dh
th
dh
Zl
Zl
Zl
Zl
"}
(8,1,1) = {"
Zl
Zl
Zl
Zl
dh
ml
ml
dh
Px
Px
dN
AI
bQ
Px
Px
dh
ml
ml
dh
Zl
Zl
Zl
Zl
"}
(9,1,1) = {"
Zl
Zl
Zl
Zl
th
ml
ml
dh
Px
Px
RS
us
RS
Px
Px
dh
ml
ml
th
Zl
Zl
Zl
Zl
"}
(10,1,1) = {"
Zl
Zl
Zl
Zl
th
ml
ml
dh
Re
Px
us
CQ
us
Px
wk
dh
ml
ml
th
Zl
Zl
Zl
Zl
"}
(11,1,1) = {"
Zl
Zl
Zl
Zl
th
ml
ml
Ge
Px
Px
RS
us
RS
Px
Px
Ge
ml
ml
th
Zl
Zl
Zl
Zl
"}
(12,1,1) = {"
Zl
Zl
Zl
Zl
th
ml
ml
Ge
Px
Px
xY
aH
ci
Px
Px
Ge
ml
ml
th
Zl
Zl
Zl
Zl
"}
(13,1,1) = {"
Zl
Zl
Zl
Zl
th
ml
mG
dh
Re
Px
Px
Px
Px
Px
wk
dh
XM
ml
th
Zl
Zl
Zl
Zl
"}
(14,1,1) = {"
Zl
Zl
Zl
Zl
dh
ml
ml
dh
Px
Px
Px
Px
Px
Px
Px
dh
ml
ml
dh
Zl
Zl
Zl
Zl
"}
(15,1,1) = {"
Zl
Zl
Zl
dh
dh
dh
dh
dh
dh
dh
Px
Pd
Px
dh
dh
dh
dh
dh
dh
dh
Zl
Zl
Zl
"}
(16,1,1) = {"
Zl
Zl
Zl
dh
oS
fT
oS
dh
Px
Px
Px
Px
Px
Px
Px
dh
Oc
fT
Oc
dh
Zl
Zl
Zl
"}
(17,1,1) = {"
Zl
Zl
Zl
dh
oS
fT
bo
dh
Re
Px
Px
Px
Px
Px
wk
dh
As
fT
Oc
dh
Zl
Zl
Zl
"}
(18,1,1) = {"
Zl
Zl
Zl
ze
fT
fT
fT
Ms
Px
Px
Px
Px
Px
Px
Px
Ms
fT
fT
fT
ze
Zl
Zl
Zl
"}
(19,1,1) = {"
Zl
Zl
Zl
ze
fT
fT
fT
Ms
Px
Px
Px
oW
Px
Px
Px
Ms
fT
fT
fT
ze
Zl
Zl
Zl
"}
(20,1,1) = {"
Zl
Zl
Zl
dh
oS
fT
oS
dh
NP
Px
Px
Zp
Px
Px
AD
dh
Oc
fT
Oc
dh
Zl
Zl
Zl
"}
(21,1,1) = {"
Zl
Zl
Zl
dh
oS
fT
bo
dh
Re
Px
Px
Px
Px
Px
Wd
dh
As
fT
Oc
dh
Zl
Zl
Zl
"}
(22,1,1) = {"
Zl
Zl
Zl
dh
oS
fT
oS
dh
Px
Px
Px
Px
Px
Px
aM
dh
Oc
fT
Oc
dh
Zl
Zl
Zl
"}
(23,1,1) = {"
Zl
Zl
Zl
dh
JS
fT
JS
dh
Px
Px
Px
Px
Px
qm
jV
dh
ZQ
fT
ZQ
dh
Zl
Zl
Zl
"}
(24,1,1) = {"
Zl
Zl
Zl
dh
Fm
Fm
Fm
dh
dh
Px
Px
dh
Px
Px
dh
dh
Fm
Fm
Fm
dh
Zl
Zl
Zl
"}
(25,1,1) = {"
Zl
Zl
Zl
dh
Fp
Fp
Fp
dh
dh
zr
Fv
WW
zr
Fv
dh
dh
Fp
Fp
Fp
dh
Zl
Zl
Zl
"}
(26,1,1) = {"
Zl
Zl
Zl
Zl
Zl
Zl
Zl
Zl
BN
BN
BN
BN
BN
BN
Kq
Zl
Zl
Zl
Zl
Zl
Zl
Zl
Zl
"}
